13 13
#############
#           #
# P       s #
#           #
#########   #
#    s  #   #
#  s W  #   #
#    s  #   #
#   LLLL#   #
#           #
#    s s    #
#           #
#############
