13 13
#############
#           #
#     P     #
#   #LLL#   #
#           #
#           #
#     G     #
#           #
#           #
#   #LLL#   #
#           #
#           #
#############
